 ---------
 -       -
 -+WWW+++-  
 -|...|SS-
 -SE-00..-
 -.0-S43B-
 -..-S.0.-
 -H.-S.E.-
 -..-SF.E-
 ---------