  --------
  -++++++-
  -|.|F.|-
  -SSSSDS-
---.00..H-
-++0S0S..-
-||..E00S-
-KT0S0S.S-
-.....E.S-
----------