---------
-       -
-+WWW+++-  
-|....||-
-SE-00..-
-.0-S33B-
-..-S.0.-
-H.-S.E.-
-..-SF.E-
---------