----------
-        -
-W++WW++W-
-H|K.B||.-
-.B03.D..-
-B.B.BB.F-
-.B.B.BB.-
-S.B.B.SS-
----------
