----------
-        -
-WW+WW+++-
-SSSS..||-
-BBBB....-
-...... .-
-....EETF-
-...E.EE.-
-H...E.E.-
----------